 /1#1#1#1#1#1#1/1
 /2#3x3x3x3x3x3#3
 /2#3x3x3x3x3#3/3
 #2#3x3#3x3$3x3#3
 #2.3x3.3@3.3x3#3
 #2x3$3x3$3x3#3#3
 #2#3#3$3#3.3#3/3
 /2/3#3x3x3x3#3/3
 /2/3#3#3#3#3#3/3